#########
#     2 #
#     2 #
#   1 2 #
# 0 1 2 #
##C#B#A##