#########
#       #
#1122233#
#1C A B3#
# # # # #
# # # # #
#########