#########
#    3  C
#   22  B
A  111  #
#########