#########
#  2 1  #
#  2 1  #
#  A B  #
#  # #  #
#########