#######
#     A
#  # ##
#    ##
#    ##
# #   #
#    ##
#11  ##
#11  ##
#######