#########
#  222  #
#   #   #
#       A
#       B
# 1   3 C
# 1   3 #
#########