###############
###         22C
###    3    ###
###    3    ###
#B1    3     A
####  ###  ###
#########  ###
##############