###########
#11       A
##       ##
##       #
##       #
## 2 3 4 #
## 2 3 4 #
## 2 3 4 #
###B#C#D##