####B########
#11111      A
##    2    ##
##    2    #
##    2    #
##    2    #
##    2    #
##    2    #
############