##########
#1       A
## ##3## #
##   3   B
##  #3#  #
##  ###  #
##   2   C
#####2####
##########