#########A#####
####C         B
######    111##
######  #  1 ##
######     # ##
######       ##
###### #     ###
######    #  33#
####22       ###
######       ###
######       ##
###############