##########
#   31   A
B   32   #
#   34   C
D   44   #
##########